구분,읍면,법정리,행정리,년도,세대수,인구수(총계),인구수(남),인구수(여)
경상북도 울릉군,울릉읍,도동리,도동1리,2008,625,1416,700,716
경상북도 울릉군,울릉읍,도동리,도동2리,2008,648,1592,837,755
경상북도 울릉군,울릉읍,도동리,도동3리,2008,785,1615,827,788
경상북도 울릉군,울릉읍,독도리,독도리,2008,2,4,2,2
경상북도 울릉군,울릉읍,저동리,저동1리,2008,638,1496,778,718
경상북도 울릉군,울릉읍,저동리,저동2리,2008,130,315,166,149
경상북도 울릉군,울릉읍,저동리,저동3리,2008,30,66,33,33
경상북도 울릉군,울릉읍,사동리,사동1리,2008,211,391,216,175
경상북도 울릉군,울릉읍,사동리,사동2리,2008,62,123,65,58
경상북도 울릉군,울릉읍,사동리,사동3리,2008,97,225,119,106
경상북도 울릉군,서면,남양리,남양1리,2008,215,497,269,228
경상북도 울릉군,서면,남양리,남양2리,2008,38,92,48,44
경상북도 울릉군,서면,남양리,남양3리,2008,83,211,112,99
경상북도 울릉군,서면,남서리,남서1리,2008,92,197,102,95
경상북도 울릉군,서면,남서리,남서2리,2008,18,30,16,14
경상북도 울릉군,서면,태하리,태하1리,2008,223,457,243,214
경상북도 울릉군,서면,태하리,태하2리,2008,36,73,37,36
경상북도 울릉군,북면,천부리,천부1리,2008,279,610,319,291
경상북도 울릉군,북면,천부리,천부2리,2008,14,22,12,10
경상북도 울릉군,북면,천부리,천부3리,2008,23,45,23,22
경상북도 울릉군,북면,천부리,천부4리,2008,33,56,31,25
경상북도 울릉군,북면,나리,나리,2008,21,43,21,22
경상북도 울릉군,북면,나리,추산리,2008,70,156,89,67
경상북도 울릉군,북면,현포리,현포1리,2008,151,326,163,163
경상북도 울릉군,북면,현포리,현포2리,2008,48,106,56,50
경상북도 울릉군,울릉읍,도동리,도동1리,2009,642,1439,707,732
경상북도 울릉군,울릉읍,도동리,도동2리,2009,691,1601,830,771
경상북도 울릉군,울릉읍,도동리,도동3리,2009,807,1566,817,749
경상북도 울릉군,울릉읍,독도리,독도리,2009,3,4,3,1
경상북도 울릉군,울릉읍,저동리,저동1리,2009,718,1623,834,789
경상북도 울릉군,울릉읍,저동리,저동2리,2009,130,287,153,134
경상북도 울릉군,울릉읍,저동리,저동3리,2009,33,67,36,31
경상북도 울릉군,울릉읍,사동리,사동1리,2009,216,375,219,156
경상북도 울릉군,울릉읍,사동리,사동2리,2009,67,133,71,62
경상북도 울릉군,울릉읍,사동리,사동3리,2009,108,234,130,104
경상북도 울릉군,서면,남양리,남양1리,2009,214,492,265,227
경상북도 울릉군,서면,남양리,남양2리,2009,41,99,55,44
경상북도 울릉군,서면,남양리,남양3리,2009,82,198,108,90
경상북도 울릉군,서면,남서리,남서1리,2009,92,200,99,101
경상북도 울릉군,서면,남서리,남서2리,2009,22,36,17,19
경상북도 울릉군,서면,태하리,태하1리,2009,245,481,259,222
경상북도 울릉군,서면,태하리,태하2리,2009,44,78,44,34
경상북도 울릉군,북면,천부리,천부1리,2009,292,611,319,292
경상북도 울릉군,북면,천부리,천부2리,2009,19,31,17,14
경상북도 울릉군,북면,천부리,천부3리,2009,28,49,29,20
경상북도 울릉군,북면,천부리,천부4리,2009,36,63,36,27
경상북도 울릉군,북면,나리,나리,2009,21,45,21,24
경상북도 울릉군,북면,나리,추산리,2009,75,159,96,63
경상북도 울릉군,북면,현포리,현포1리,2009,173,344,172,172
경상북도 울릉군,북면,현포리,현포2리,2009,49,110,56,54
경상북도 울릉군,울릉읍,도동리,도동1리,2010,693,1455,722,733
경상북도 울릉군,울릉읍,도동리,도동2리,2010,849,1794,938,856
경상북도 울릉군,울릉읍,도동리,도동3리,2010,829,1546,810,736
경상북도 울릉군,울릉읍,독도리,독도리,2010,6,7,6,1
경상북도 울릉군,울릉읍,저동리,저동1리,2010,751,1702,887,815
경상북도 울릉군,울릉읍,저동리,저동2리,2010,140,297,153,144
경상북도 울릉군,울릉읍,저동리,저동3리,2010,40,72,41,31
경상북도 울릉군,울릉읍,사동리,사동1리,2010,218,390,235,155
경상북도 울릉군,울릉읍,사동리,사동2리,2010,70,136,72,64
경상북도 울릉군,울릉읍,사동리,사동3리,2010,113,231,130,101
경상북도 울릉군,서면,남양리,남양1리,2010,229,524,273,251
경상북도 울릉군,서면,남양리,남양2리,2010,40,99,51,48
경상북도 울릉군,서면,남양리,남양3리,2010,83,191,98,93
경상북도 울릉군,서면,남서리,남서1리,2010,97,199,100,99
경상북도 울릉군,서면,남서리,남서2리,2010,19,35,16,19
경상북도 울릉군,서면,태하리,태하1리,2010,258,481,269,212
경상북도 울릉군,서면,태하리,태하2리,2010,65,90,45,45
경상북도 울릉군,북면,천부리,천부1리,2010,314,627,326,301
경상북도 울릉군,북면,천부리,천부2리,2010,21,34,19,15
경상북도 울릉군,북면,천부리,천부3리,2010,29,50,32,18
경상북도 울릉군,북면,천부리,천부4리,2010,38,65,38,27
경상북도 울릉군,북면,나리,나리,2010,21,35,18,17
경상북도 울릉군,북면,나리,추산리,2010,74,152,85,67
경상북도 울릉군,북면,현포리,현포1리,2010,196,375,200,175
경상북도 울릉군,북면,현포리,현포2리,2010,49,103,55,48
경상북도 울릉군,울릉읍,도동리,도동1리,2011,665,1407,694,713
경상북도 울릉군,울릉읍,도동리,도동2리,2011,857,1781,934,847
경상북도 울릉군,울릉읍,도동리,도동3리,2011,873,1582,827,755
경상북도 울릉군,울릉읍,독도리,독도리,2011,10,11,10,1
경상북도 울릉군,울릉읍,저동리,저동1리,2011,742,1704,887,817
경상북도 울릉군,울릉읍,저동리,저동2리,2011,146,304,156,148
경상북도 울릉군,울릉읍,저동리,저동3리,2011,39,67,39,28
경상북도 울릉군,울릉읍,사동리,사동1리,2011,242,413,251,162
경상북도 울릉군,울릉읍,사동리,사동2리,2011,79,152,80,72
경상북도 울릉군,울릉읍,사동리,사동3리,2011,107,227,126,101
경상북도 울릉군,서면,남양리,남양1리,2011,223,494,262,232
경상북도 울릉군,서면,남양리,남양2리,2011,40,103,54,49
경상북도 울릉군,서면,남양리,남양3리,2011,86,202,100,102
경상북도 울릉군,서면,남서리,남서1리,2011,98,201,103,98
경상북도 울릉군,서면,남서리,남서2리,2011,20,34,15,19
경상북도 울릉군,서면,태하리,태하1리,2011,270,513,277,236
경상북도 울릉군,서면,태하리,태하2리,2011,60,80,41,39
경상북도 울릉군,북면,천부리,천부1리,2011,310,620,318,302
경상북도 울릉군,북면,천부리,천부2리,2011,29,44,24,20
경상북도 울릉군,북면,천부리,천부3리,2011,30,50,31,19
경상북도 울릉군,북면,천부리,천부4리,2011,32,52,31,21
경상북도 울릉군,북면,나리,나리,2011,21,36,18,18
경상북도 울릉군,북면,나리,추산리,2011,69,143,74,69
경상북도 울릉군,북면,현포리,현포1리,2011,208,380,207,173
경상북도 울릉군,북면,현포리,현포2리,2011,55,119,63,56
경상북도 울릉군,울릉읍,도동리,도동1리,2012,667,1369,685,684
경상북도 울릉군,울릉읍,도동리,도동2리,2012,893,1832,971,861
경상북도 울릉군,울릉읍,도동리,도동3리,2012,860,1575,816,759
경상북도 울릉군,울릉읍,독도리,독도리,2012,9,10,9,1
경상북도 울릉군,울릉읍,저동리,저동1리,2012,768,1704,889,815
경상북도 울릉군,울릉읍,저동리,저동2리,2012,144,290,150,140
경상북도 울릉군,울릉읍,저동리,저동3리,2012,46,78,43,35
경상북도 울릉군,울릉읍,사동리,사동1리,2012,222,383,221,152
경상북도 울릉군,울릉읍,사동리,사동2리,2012,83,150,83,67
경상북도 울릉군,울릉읍,사동리,사동3리,2012,103,217,116,101
경상북도 울릉군,서면,남양리,남양1리,2012,239,498,264,234
경상북도 울릉군,서면,남양리,남양2리,2012,239,498,264,234
경상북도 울릉군,서면,남양리,남양3리,2012,92,217,109,108
경상북도 울릉군,서면,남서리,남서1리,2012,98,183,101,82
경상북도 울릉군,서면,남서리,남서2리,2012,21,33,14,19
경상북도 울릉군,서면,태하리,태하1리,2012,275,495,268,227
경상북도 울릉군,서면,태하리,태하2리,2012,51,76,40,36
경상북도 울릉군,북면,천부리,천부1리,2012,314,623,326,297
경상북도 울릉군,북면,천부리,천부2리,2012,44,60,37,23
경상북도 울릉군,북면,천부리,천부3리,2012,34,55,34,21
경상북도 울릉군,북면,천부리,천부4리,2012,35,54,32,22
경상북도 울릉군,북면,나리,나리,2012,20,34,19,15
경상북도 울릉군,북면,나리,추산리,2012,77,140,84,56
경상북도 울릉군,북면,현포리,현포1리,2012,196,374,204,170
경상북도 울릉군,북면,현포리,현포2리,2012,59,121,64,57
경상북도 울릉군,울릉읍,도동리,도동1리,2013,681,1402,710,692
경상북도 울릉군,울릉읍,도동리,도동2리,2013,868,1791,944,847
경상북도 울릉군,울릉읍,도동리,도동3리,2013,878,1596,828,768
경상북도 울릉군,울릉읍,독도리,독도리,2013,20,21,20,1
경상북도 울릉군,울릉읍,저동리,저동1리,2013,778,1653,866,787
경상북도 울릉군,울릉읍,저동리,저동2리,2013,138,278,146,132
경상북도 울릉군,울릉읍,저동리,저동3리,2013,39,64,36,28
경상북도 울릉군,울릉읍,사동리,사동1리,2013,218,364,215,149
경상북도 울릉군,울릉읍,사동리,사동2리,2013,89,154,85,69
경상북도 울릉군,울릉읍,사동리,사동3리,2013,99,216,117,99
경상북도 울릉군,서면,남양리,남양1리,2013,226,464,247,217
경상북도 울릉군,서면,남양리,남양2리,2013,36,98,53,45
경상북도 울릉군,서면,남양리,남양3리,2013,92,208,99,109
경상북도 울릉군,서면,남서리,남서1리,2013,106,202,111,91
경상북도 울릉군,서면,남서리,남서2리,2013,24,37,18,19
경상북도 울릉군,서면,태하리,태하1리,2013,242,423,219,204
경상북도 울릉군,서면,태하리,태하2리,2013,48,70,38,32
경상북도 울릉군,북면,천부리,천부1리,2013,334,620,333,287
경상북도 울릉군,북면,천부리,천부2리,2013,47,71,43,28
경상북도 울릉군,북면,천부리,천부3리,2013,43,66,41,25
경상북도 울릉군,북면,천부리,천부4리,2013,33,53,33,20
경상북도 울릉군,북면,나리,나리,2013,30,45,25,20
경상북도 울릉군,북면,나리,추산리,2013,75,124,76,48
경상북도 울릉군,북면,현포리,현포1리,2013,192,370,201,169
경상북도 울릉군,북면,현포리,현포2리,2013,60,122,64,58
경상북도 울릉군,울릉읍,도동리,도동1리,2014,673,1357,689,668
경상북도 울릉군,울릉읍,도동리,도동2리,2014,880,1731,929,802
경상북도 울릉군,울릉읍,도동리,도동3리,2014,829,1492,767,725
경상북도 울릉군,울릉읍,독도리,독도리,2014,27,28,27,1
경상북도 울릉군,울릉읍,저동리,저동1리,2014,773,1623,861,762
경상북도 울릉군,울릉읍,저동리,저동2리,2014,146,288,154,134
경상북도 울릉군,울릉읍,저동리,저동3리,2014,43,69,39,30
경상북도 울릉군,울릉읍,사동리,사동1리,2014,211,342,204,138
경상북도 울릉군,울릉읍,사동리,사동2리,2014,82,148,83,65
경상북도 울릉군,울릉읍,사동리,사동3리,2014,103,217,119,98
경상북도 울릉군,서면,남양리,남양1리,2014,242,475,251,224
경상북도 울릉군,서면,남양리,남양2리,2014,36,95,51,44
경상북도 울릉군,서면,남양리,남양3리,2014,95,209,99,110
경상북도 울릉군,서면,남서리,남서1리,2014,108,203,110,93
경상북도 울릉군,서면,남서리,남서2리,2014,25,41,21,20
경상북도 울릉군,서면,태하리,태하1리,2014,248,417,221,196
경상북도 울릉군,서면,태하리,태하2리,2014,46,71,42,29
경상북도 울릉군,북면,천부리,천부1리,2014,327,601,317,284
경상북도 울릉군,북면,천부리,천부2리,2014,49,68,46,22
경상북도 울릉군,북면,천부리,천부3리,2014,29,56,32,24
경상북도 울릉군,북면,천부리,천부4리,2014,30,48,31,17
경상북도 울릉군,북면,나리,나리,2014,29,45,24,21
경상북도 울릉군,북면,나리,추산리,2014,74,133,82,51
경상북도 울릉군,북면,현포리,현포1리,2014,202,389,216,173
경상북도 울릉군,북면,현포리,현포2리,2014,57,118,62,56
경상북도 울릉군,울릉읍,도동리,도동1리,2015,670,1336,676,660
경상북도 울릉군,울릉읍,도동리,도동2리,2015,893,1735,937,798
경상북도 울릉군,울릉읍,도동리,도동3리,2015,824,1447,754,693
경상북도 울릉군,울릉읍,독도리,독도리,2015,22,23,22,1
경상북도 울릉군,울릉읍,저동리,저동1리,2015,758,1614,855,759
경상북도 울릉군,울릉읍,저동리,저동2리,2015,141,281,149,132
경상북도 울릉군,울릉읍,저동리,저동3리,2015,42,65,36,29
경상북도 울릉군,울릉읍,사동리,사동1리,2015,205,343,205,138
경상북도 울릉군,울릉읍,사동리,사동2리,2015,90,158,98,60
경상북도 울릉군,울릉읍,사동리,사동3리,2015,106,219,118,101
경상북도 울릉군,서면,남양리,남양1리,2015,222,443,237,206
경상북도 울릉군,서면,남양리,남양2리,2015,34,104,55,49
경상북도 울릉군,서면,남양리,남양3리,2015,96,206,94,112
경상북도 울릉군,서면,남서리,남서1리,2015,108,217,116,101
경상북도 울릉군,서면,남서리,남서2리,2015,22,32,15,17
경상북도 울릉군,서면,태하리,태하1리,2015,260,428,234,194
경상북도 울릉군,서면,태하리,태하2리,2015,46,71,43,28
경상북도 울릉군,북면,천부리,천부1리,2015,318,567,299,268
경상북도 울릉군,북면,천부리,천부2리,2015,57,80,54,26
경상북도 울릉군,북면,천부리,천부3리,2015,30,48,27,21
경상북도 울릉군,북면,천부리,천부4리,2015,30,52,32,20
경상북도 울릉군,북면,나리,나리,2015,24,37,21,16
경상북도 울릉군,북면,나리,추산리,2015,76,140,86,54
경상북도 울릉군,북면,현포리,현포1리,2015,190,399,215,184
경상북도 울릉군,북면,현포리,현포2리,2015,55,108,57,51
경상북도 울릉군,울릉읍,도동리,도동1리,2016,669,1308,687,621
경상북도 울릉군,울릉읍,도동리,도동2리,2016,875,1670,920,750
경상북도 울릉군,울릉읍,도동리,도동3리,2016,794,1409,741,668
경상북도 울릉군,울릉읍,독도리,독도리,2016,23,24,23,1
경상북도 울릉군,울릉읍,저동리,저동1리,2016,764,1602,851,751
경상북도 울릉군,울릉읍,저동리,저동2리,2016,143,280,151,129
경상북도 울릉군,울릉읍,저동리,저동3리,2016,38,62,33,29
경상북도 울릉군,울릉읍,사동리,사동1리,2016,219,349,218,131
경상북도 울릉군,울릉읍,사동리,사동2리,2016,101,174,108,66
경상북도 울릉군,울릉읍,사동리,사동3리,2016,125,240,135,105
경상북도 울릉군,서면,남양리,남양1리,2016,216,428,235,193
경상북도 울릉군,서면,남양리,남양2리,2016,35,104,55,49
경상북도 울릉군,서면,남양리,남양3리,2016,88,198,86,112
경상북도 울릉군,서면,남서리,남서1리,2016,111,207,114,93
경상북도 울릉군,서면,남서리,남서2리,2016,21,31,15,16
경상북도 울릉군,서면,태하리,태하1리,2016,245,404,216,188
경상북도 울릉군,서면,태하리,태하2리,2016,51,75,45,30
경상북도 울릉군,북면,천부리,천부1리,2016,330,583,304,279
경상북도 울릉군,북면,천부리,천부2리,2016,59,82,57,25
경상북도 울릉군,북면,천부리,천부3리,2016,30,50,25,25
경상북도 울릉군,북면,천부리,천부4리,2016,33,57,33,24
경상북도 울릉군,북면,나리,나리,2016,22,32,20,12
경상북도 울릉군,북면,나리,추산리,2016,75,128,80,48
경상북도 울릉군,북면,현포리,현포1리,2016,201,400,224,176
경상북도 울릉군,북면,현포리,현포2리,2016,55,104,54,50
경상북도 울릉군,울릉읍,도동리,도동1리,2017,675,1287,681,606
경상북도 울릉군,울릉읍,도동리,도동2리,2017,854,1643,902,741
경상북도 울릉군,울릉읍,도동리,도동3리,2017,814,1392,729,663
경상북도 울릉군,울릉읍,독도리,독도리,2017,19,20,19,1
경상북도 울릉군,울릉읍,저동리,저동1리,2017,775,1560,834,726
경상북도 울릉군,울릉읍,저동리,저동2리,2017,148,275,156,119
경상북도 울릉군,울릉읍,저동리,저동3리,2017,38,61,33,28
경상북도 울릉군,울릉읍,사동리,사동1리,2017,237,380,239,141
경상북도 울릉군,울릉읍,사동리,사동2리,2017,105,173,110,63
경상북도 울릉군,울릉읍,사동리,사동3리,2017,129,245,141,104
경상북도 울릉군,서면,남양리,남양1리,2017,225,450,249,201
경상북도 울릉군,서면,남양리,남양2리,2017,32,91,47,44
경상북도 울릉군,서면,남양리,남양3리,2017,103,204,96,108
경상북도 울릉군,서면,남서리,남서1리,2017,110,203,114,89
경상북도 울릉군,서면,남서리,남서2리,2017,20,31,16,15
경상북도 울릉군,서면,태하리,태하1리,2017,253,409,214,195
경상북도 울릉군,서면,태하리,태하2리,2017,52,234,195,39
경상북도 울릉군,북면,천부리,천부1리,2017,331,583,298,285
경상북도 울릉군,북면,천부리,천부2리,2017,76,96,71,25
경상북도 울릉군,북면,천부리,천부3리,2017,31,54,27,27
경상북도 울릉군,북면,천부리,천부4리,2017,41,70,40,30
경상북도 울릉군,북면,나리,나리,2017,75,129,82,47
경상북도 울릉군,북면,나리,추산리,2017,22,39,25,14
경상북도 울릉군,북면,현포리,현포1리,2017,205,387,218,169
경상북도 울릉군,북면,현포리,현포2리,2017,62,107,54,53
경상북도 울릉군,울릉읍,도동리,도동1리,2018,693,1268,673,595
경상북도 울릉군,울릉읍,도동리,도동2리,2018,836,1565,852,713
경상북도 울릉군,울릉읍,도동리,도동3리,2018,835,1419,734,685
경상북도 울릉군,울릉읍,독도리,독도리,2018,19,19,18,1
경상북도 울릉군,울릉읍,저동리,저동1리,2018,772,1551,826,725
경상북도 울릉군,울릉읍,저동리,저동2리,2018,149,263,145,118
경상북도 울릉군,울릉읍,저동리,저동3리,2018,31,55,27,28
경상북도 울릉군,울릉읍,사동리,사동1리,2018,223,349,228,121
경상북도 울릉군,울릉읍,사동리,사동2리,2018,103,163,99,64
경상북도 울릉군,울릉읍,사동리,사동3리,2018,130,244,135,109
경상북도 울릉군,서면,남양리,남양1리,2018,242,453,257,196
경상북도 울릉군,서면,남양리,남양2리,2018,34,94,47,47
경상북도 울릉군,서면,남양리,남양3리,2018,95,188,86,102
경상북도 울릉군,서면,남서리,남서1리,2018,126,221,126,95
경상북도 울릉군,서면,남서리,남서2리,2018,18,28,15,13
경상북도 울릉군,서면,태하리,태하1리,2018,247,408,207,201
경상북도 울릉군,서면,태하리,태하2리,2018,53,83,47,36
경상북도 울릉군,북면,천부리,천부1리,2018,360,590,296,294
경상북도 울릉군,북면,천부리,천부2리,2018,78,96,69,27
경상북도 울릉군,북면,천부리,천부3리,2018,27,45,23,22
경상북도 울릉군,북면,천부리,천부4리,2018,40,69,40,29
경상북도 울릉군,북면,나리,나리,2018,78,120,78,42
경상북도 울릉군,북면,나리,추산리,2018,26,44,28,16
경상북도 울릉군,북면,현포리,현포1리,2018,213,390,216,174
경상북도 울릉군,북면,현포리,현포2리,2018,62,107,56,51
경상북도 울릉군,울릉읍,도동리,도동1리,2019,706,1126,642,584
경상북도 울릉군,울릉읍,도동리,도동2리,2019,875,1610,876,734
경상북도 울릉군,울릉읍,도동리,도동3리,2019,812,1368,717,651
경상북도 울릉군,울릉읍,독도리,독도리,2019,14,14,13,1
경상북도 울릉군,울릉읍,저동리,저동1리,2019,744,1454,779,675
경상북도 울릉군,울릉읍,저동리,저동2리,2019,141,247,132,115
경상북도 울릉군,울릉읍,저동리,저동3리,2019,32,59,29,30
경상북도 울릉군,울릉읍,사동리,사동1리,2019,235,357,239,118
경상북도 울릉군,울릉읍,사동리,사동2리,2019,107,173,105,68
경상북도 울릉군,울릉읍,사동리,사동3리,2019,144,258,152,106
경상북도 울릉군,서면,남양리,남양1리,2019,193,412,228,184
경상북도 울릉군,서면,남양리,남양2리,2019,33,92,49,43
경상북도 울릉군,서면,남양리,남양3리,2019,86,169,79,90
경상북도 울릉군,서면,남서리,남서1리,2019,117,211,120,91
경상북도 울릉군,서면,남서리,남서2리,2019,16,27,15,12
경상북도 울릉군,서면,태하리,태하1리,2019,247,411,213,198
경상북도 울릉군,서면,태하리,태하2리,2019,61,90,53,37
경상북도 울릉군,북면,천부리,천부1리,2019,335,557,276,281
경상북도 울릉군,북면,천부리,천부2리,2019,69,93,65,28
경상북도 울릉군,북면,천부리,천부3리,2019,28,44,19,25
경상북도 울릉군,북면,천부리,천부4리,2019,41,66,35,31
경상북도 울릉군,북면,나리,나리,2019,82,134,85,49
경상북도 울릉군,북면,나리,추산리,2019,27,44,27,17
경상북도 울릉군,북면,현포리,현포1리,2019,218,398,224,174
경상북도 울릉군,북면,현포리,현포2리,2019,63,103,58,45
경상북도 울릉군,울릉읍,도동리,도동1리,2020,646,1096,583,513
경상북도 울릉군,울릉읍,도동리,도동2리,2020,898,1577,850,727
경상북도 울릉군,울릉읍,도동리,도동3리,2020,762,1262,666,596
경상북도 울릉군,울릉읍,독도리,독도리,2020,13,13,12,1
경상북도 울릉군,울릉읍,저동리,저동1리,2020,747,1422,759,663
경상북도 울릉군,울릉읍,저동리,저동2리,2020,137,221,120,101
경상북도 울릉군,울릉읍,저동리,저동3리,2020,34,56,30,26
경상북도 울릉군,울릉읍,사동리,사동1리,2020,257,388,256,132
경상북도 울릉군,울릉읍,사동리,사동2리,2020,98,158,94,64
경상북도 울릉군,울릉읍,사동리,사동3리,2020,131,241,136,105
경상북도 울릉군,서면,남양리,남양1리,2020,200,390,217,173
경상북도 울릉군,서면,남양리,남양2리,2020,42,95,53,42
경상북도 울릉군,서면,남양리,남양3리,2020,87,158,76,82
경상북도 울릉군,서면,남서리,남서1리,2020,116,206,119,87
경상북도 울릉군,서면,남서리,남서2리,2020,17,29,15,14
경상북도 울릉군,서면,태하리,태하1리,2020,223,356,186,170
경상북도 울릉군,서면,태하리,태하2리,2020,59,88,53,35
경상북도 울릉군,북면,천부리,천부1리,2020,337,499,256,243
경상북도 울릉군,북면,천부리,천부2리,2020,59,80,56,24
경상북도 울릉군,북면,천부리,천부3리,2020,27,44,19,25
경상북도 울릉군,북면,천부리,천부4리,2020,37,66,35,31
경상북도 울릉군,북면,나리,나리,2020,78,111,71,40
경상북도 울릉군,북면,나리,추산리,2020,30,46,27,19
경상북도 울릉군,북면,현포리,현포1리,2020,213,376,213,163
경상북도 울릉군,북면,현포리,현포2리,2020,64,99,54,45
경상북도 울릉군,울릉읍,도동리,도동1리,2021,620,1037,541,496
경상북도 울릉군,울릉읍,도동리,도동2리,2021,860,1517,834,683
경상북도 울릉군,울릉읍,도동리,도동3리,2021,759,1225,653,572
경상북도 울릉군,울릉읍,독도리,독도리,2021,26,26,25,1
경상북도 울릉군,울릉읍,저동리,저동1리,2021,726,1356,717,639
경상북도 울릉군,울릉읍,저동리,저동2리,2021,147,233,127,106
경상북도 울릉군,울릉읍,저동리,저동3리,2021,34,56,28,28
경상북도 울릉군,울릉읍,사동리,사동1리,2021,268,407,268,139
경상북도 울릉군,울릉읍,사동리,사동2리,2021,100,157,93,64
경상북도 울릉군,울릉읍,사동리,사동3리,2021,159,264,160,104
경상북도 울릉군,서면,남양리,남양1리,2021,188,382,208,174
경상북도 울릉군,서면,남양리,남양2리,2021,39,83,47,36
경상북도 울릉군,서면,남양리,남양3리,2021,89,152,73,79
경상북도 울릉군,서면,남서리,남서1리,2021,129,235,130,105
경상북도 울릉군,서면,남서리,남서2리,2021,18,29,13,16
경상북도 울릉군,서면,태하리,태하1리,2021,220,355,191,164
경상북도 울릉군,서면,태하리,태하2리,2021,58,88,51,37
경상북도 울릉군,북면,천부리,천부1리,2021,318,475,239,236
경상북도 울릉군,북면,천부리,천부2리,2021,53,69,42,27
경상북도 울릉군,북면,천부리,천부3리,2021,24,40,18,22
경상북도 울릉군,북면,천부리,천부4리,2021,37,66,36,30
경상북도 울릉군,북면,나리,나리,2021,83,114,73,41
경상북도 울릉군,북면,나리,추산리,2021,34,54,33,21
경상북도 울릉군,북면,현포리,현포1리,2021,210,359,203,156
경상북도 울릉군,북면,현포리,현포2리,2021,59,88,48,40
경상북도 울릉군,울릉읍,도동리,도동1리,2022,661,"1,100",574,526
경상북도 울릉군,울릉읍,도동리,도동2리,2022,880,"1,495",818,677
경상북도 울릉군,울릉읍,도동리,도동3리,2022,772,"1,246",671,575
경상북도 울릉군,울릉읍,독도리,독도리,2022,761,"1,356",733,623
경상북도 울릉군,울릉읍,저동리,저동1리,2022,141,235,125,110
경상북도 울릉군,울릉읍,저동리,저동2리,2022,32,52,28,24
경상북도 울릉군,울릉읍,저동리,저동3리,2022,303,442,295,147
경상북도 울릉군,울릉읍,사동리,사동1리,2022,85,128,72,56
경상북도 울릉군,울릉읍,사동리,사동2리,2022,189,290,180,110
경상북도 울릉군,울릉읍,사동리,사동3리,2022,27,27,26,1
경상북도 울릉군,서면,남양리,남양1리,2022,198,371,210,161
경상북도 울릉군,서면,남양리,남양2리,2022,37,91,50,41
경상북도 울릉군,서면,남양리,남양3리,2022,101,168,85,83
경상북도 울릉군,서면,남서리,남서1리,2022,138,238,130,108
경상북도 울릉군,서면,남서리,남서2리,2022,22,33,15,18
경상북도 울릉군,서면,태하리,태하1리,2022,225,355,197,158
경상북도 울릉군,서면,태하리,태하2리,2022,59,89,53,36
경상북도 울릉군,북면,천부리,천부1리,2022,329,491,252,239
경상북도 울릉군,북면,천부리,천부2리,2022,42,57,33,24
경상북도 울릉군,북면,천부리,천부3리,2022,28,48,22,26
경상북도 울릉군,북면,천부리,천부4리,2022,42,67,40,27
경상북도 울릉군,북면,나리,나리,2022,34,55,36,19
경상북도 울릉군,북면,나리,추산리,2022,82,108,67,41
경상북도 울릉군,북면,현포리,현포1리,2022,215,341,198,143
경상북도 울릉군,북면,현포리,현포2리,2022,75,112,66,46
경상북도 울릉군,울릉읍,도동리,도동1리,2023,662,1088,574,514
경상북도 울릉군,울릉읍,도동리,도동2리,2023,909,1523,823,700
경상북도 울릉군,울릉읍,도동리,도동3리,2023,775,1247,668,579
경상북도 울릉군,울릉읍,독도리,독도리,2023,758,1329,725,604
경상북도 울릉군,울릉읍,저동리,저동1리,2023,138,229,116,113
경상북도 울릉군,울릉읍,저동리,저동2리,2023,40,63,36,27
경상북도 울릉군,울릉읍,저동리,저동3리,2023,328,473,316,157
경상북도 울릉군,울릉읍,사동리,사동1리,2023,89,135,79,56
경상북도 울릉군,울릉읍,사동리,사동2리,2023,213,302,193,109
경상북도 울릉군,울릉읍,사동리,사동3리,2023,34,34,33,1
경상북도 울릉군,서면,남양리,남양1리,2023,195,366,204,162
경상북도 울릉군,서면,남양리,남양2리,2023,50,107,60,47
경상북도 울릉군,서면,남양리,남양3리,2023,105,174,93,81
경상북도 울릉군,서면,남서리,남서1리,2023,142,233,133,100
경상북도 울릉군,서면,남서리,남서2리,2023,22,30,13,17
경상북도 울릉군,서면,태하리,태하1리,2023,224,367,206,161
경상북도 울릉군,서면,태하리,태하2리,2023,55,87,54,33
경상북도 울릉군,북면,천부리,천부1리,2023,319,470,237,233
경상북도 울릉군,북면,천부리,천부2리,2023,50,68,37,31
경상북도 울릉군,북면,천부리,천부3리,2023,28,44,21,23
경상북도 울릉군,북면,천부리,천부4리,2023,40,64,38,26
경상북도 울릉군,북면,나리,나리,2023,37,59,37,22
경상북도 울릉군,북면,나리,추산리,2023,82,103,69,34
경상북도 울릉군,북면,현포리,현포1리,2023,227,356,198,158
경상북도 울릉군,북면,현포리,현포2리,2023,83,126,70,56
경상북도 울릉군,울릉읍,도동리,도동1리,2024,672,1104,582,522
경상북도 울릉군,울릉읍,도동리,도동2리,2024,889,1518,835,683
경상북도 울릉군,울릉읍,도동리,도동3리,2024,770,1213,649,564
경상북도 울릉군,울릉읍,독도리,독도리,2024,39,39,38,1
경상북도 울릉군,울릉읍,저동리,저동1리,2024,774,"1,332",731,601
경상북도 울릉군,울릉읍,저동리,저동2리,2024,138,229,118,111
경상북도 울릉군,울릉읍,저동리,저동3리,2024,37,57,32,25
경상북도 울릉군,울릉읍,사동리,사동1리,2024,341,485,322,163
경상북도 울릉군,울릉읍,사동리,사동2리,2024,93,139,84,55
경상북도 울릉군,울릉읍,사동리,사동3리,2024,217,307,199,108
경상북도 울릉군,서면,남양리,남양1리,2024,212,364,207,157
경상북도 울릉군,서면,남양리,남양2리,2024,51,106,61,45
경상북도 울릉군,서면,남양리,남양3리,2024,118,189,105,84
경상북도 울릉군,서면,남서리,남서1리,2024,148,251,140,111
경상북도 울릉군,서면,남서리,남서2리,2024,23,34,15,19
경상북도 울릉군,서면,태하리,태하1리,2024,221,361,199,162
경상북도 울릉군,서면,태하리,태하2리,2024,61,89,50,39
경상북도 울릉군,북면,천부리,천부1리,2024,329,489,249,240
경상북도 울릉군,북면,천부리,천부2리,2024,48,67,36,31
경상북도 울릉군,북면,천부리,천부3리,2024,28,48,24,24
경상북도 울릉군,북면,천부리,천부4리,2024,41,65,38,27
경상북도 울릉군,북면,나리,나리,2024,37,59,40,19
경상북도 울릉군,북면,나리,추산리,2024,85,112,72,40
경상북도 울릉군,북면,현포리,현포1리,2024,236,378,210,168
경상북도 울릉군,북면,현포리,현포2리,2024,81,127,69,58